XXXXXXXXXXXXXXXXXXXXXXXXXXXXXXXXXXXXXXX
XXXXXXXXXXXXXXXXXXXXXXXXXXXXXXXXXXXXXXX
XXXXXXXXXXXXXXXXXXXXXXXXXXXXXXXXXXXXXXX
XXXXXXXXXXXXXXXXXXXXXXXXXXXXXXXXXXXXXXX
XXXXXXXXXXXXXXX.......SXXXXXXXXXXXXXXXX
XXXXXXXXXXXXX.............XXXXXXXXXXXXX
XXXXXXXXXXXX...............XXXXXXXXXXXX
XXXXXXXXXXXX...............XXXXXXXXXXXX
XXXXXXXXXXXX................XXXXXXXXXXX
XXXXXXXXXXXS................XXXXXXXXXXX
XXXXXXXXXXX........C........XXXXXXXXXXX
XXXXXXXXXXX................SXXXXXXXXXXX
XXXXXXXXXXX................XXXXXXXXXXXX
XXXXXXXXXXX................XXXXXXXXXXXX
XXXXXXXXXXXX...............XXXXXXXXXXXX
XXXXXXXXXXXX..............XXXXXXXXXXXXX
XXXXXXXXXXXXX............XXXXXXXXXXXXXX
XXXXXXXXXXXXXXXXS......XXXXXXXXXXXXXXXX
XXXXXXXXXXXXXXXXXXXXXXXXXXXXXXXXXXXXXXX
XXXXXXXXXXXXXXXXXXXXXXXXXXXXXXXXXXXXXXX
XXXXXXXXXXXXXXXXXXXXXXXXXXXXXXXXXXXXXXX
XXXXXXXXXXXXXXXXXXXXXXXXXXXXXXXXXXXXXXX