XXXXXXXXXXXXXXXXXXXXXXXXXXXXXXXXXXXXXXX
XXXXXXXXXXXXXXXXXXXXXXXXXXXXXXXXXXXXXXX
XXXXXXXXXXXXXXXXXXXXXXXXXXXXXXXXXXXXXXX
XXXXXXXXXXXXXXXXXXXXXXXXXXXXXXXXXXXXXXX
XXXXXXXXXXXXXS....................XXXXX
XXXX..............................SXXXX
XXXX...............................XXXX
XXXX..............XXXXX............XXXX
XXXX..........XXXXXXXXXXX..........XXXX
XXXX........XXXXXXXXXXXXXX.........XXXX
XXXX...C...XXXXXXXXXXXXXXXX........XXXX
XXXX......XXXXXXXXXXXXXXXXX....C...XXXX
XXXX......XXXXXXXXXXXXXXX..........XXXX
XXXX.......XXXXXXXXXXX.............XXXX
XXXX...............................XXXX
XXXX...............................XXXX
XXXX...............................XXXX
XXXXS..............................XXXX
XXXXX.....................SXXXXXXXXXXXX
XXXXXXXXXXXXXXXXXXXXXXXXXXXXXXXXXXXXXXX
XXXXXXXXXXXXXXXXXXXXXXXXXXXXXXXXXXXXXXX
XXXXXXXXXXXXXXXXXXXXXXXXXXXXXXXXXXXXXXX