XXXXXXXXXXXXXXXXXXXXXXXXXXXXXXXXXXXXXXX
XXXXXXXXXXXXXXXXXXXXXXXXXXXXXXXXXXXXXXX
XXXXXXXXXXXXXXXXXXXXXXXXXXXXXXXXXXXXXXX
XXXXXXXXXXXXXXXXXXXXXXXXXXXXXXXXXXXXXXX
XXXXXXXXXXXXXXXXXXXXXXXX....SXXXXXXXXXX
XXXXXXXXXXXXXXXXXXXXXXXXX....XXXXXXXXXX
XXXXXXXXXXXXXXXXXXXXXXXXXX..XXXXXXXXXXX
XXXXXS..XXXXXXXXXXXXXXXXX..XXXXXXXXXXXX
XXXXX....XXXXXXXXXXXX.....XXXXXXXXXXXXX
XXXXX.....XXXXXXXXXXX.....XXXXXXXXXXXXX
XXXX.......XXXXXXXXX......XXXXXXXX.SXXX
XXXX.........XXXXX..........XXXX....XXX
XXXX..XXXX.......................XXXXXX
XXXX..XXXXX.........C..........XXXXXXXX
XXX...XXXXX..XXX..............XXXXXXXXX
XX..........XXXXX..........XXXXXXXXXXXX
XXX.XXXX....XXXXXX.......XXXXXXXXXXXXXX
XXXXXXXXXX.SXXXXXXXXXXXXXXXXXXXXXXXXXXX
XXXXXXXXXXXXXXXXXXXXXXXXXXXXXXXXXXXXXXX
XXXXXXXXXXXXXXXXXXXXXXXXXXXXXXXXXXXXXXX
XXXXXXXXXXXXXXXXXXXXXXXXXXXXXXXXXXXXXXX
XXXXXXXXXXXXXXXXXXXXXXXXXXXXXXXXXXXXXXX